7,7,7,7,7,7,7,7,7,7,7,7,7,7,7,7,7,7,7,7,7,7,7,7,7,7,7,7,7,7,7,7,7,7,7,7,7,7,7,7,7,7,7,7,7,7,7,7,7,7,7,7,7,7,7,7,7,7,7,7,7,7,7,7,7,7,7,7,7,7,7,7,7,7,7,7,7,7,7,7,7,7,7,7,7,7,7,7,7,7,7,7,7,7,7,7,7,7,7,7,7,7,7,7,7,7,7,7,7,7
7,7,7,7,7,7,7,7,7,7,7,7,7,7,7,7,7,7,7,7,7,7,7,7,7,7,7,7,7,7,7,7,7,7,7,7,7,7,7,7,7,7,7,7,7,7,7,7,7,7,7,7,7,7,7,7,7,7,7,7,7,7,7,7,7,7,7,7,7,7,7,7,7,7,7,7,7,7,7,7,7,7,7,7,7,7,7,7,7,7,7,7,7,7,7,7,7,7,7,7,7,7,7,7,7,7,7,7,7,7
7,7,7,7,7,7,7,7,7,7,7,7,7,7,7,7,7,7,7,7,7,7,7,7,7,7,7,7,7,7,7,7,7,7,7,7,7,7,7,7,7,7,7,7,7,7,7,7,7,7,7,7,7,7,7,7,7,7,7,7,7,7,7,7,7,7,7,7,7,7,7,7,7,7,7,7,7,7,7,7,7,7,7,7,7,7,7,7,7,7,7,7,7,7,7,7,7,7,7,7,7,7,7,7,7,7,7,7,7,7
7,7,7,7,2,1,2,0,2,0,0,1,2,0,0,0,7,7,7,7,7,7,7,7,7,7,1,0,2,1,1,1,2,7,7,7,7,7,7,7,7,7,2,0,1,1,0,1,1,7,7,7,7,1,2,0,2,1,2,0,0,1,2,7,7,7,1,1,0,0,1,2,7,7,7,7,7,0,1,1,3,3,7,7,7,1,2,2,2,2,2,7,7,7,7,7,7,7,7,2,2,2,2,2,1,7,7,7,7,7
7,7,7,0,2,0,0,1,1,0,0,1,0,0,2,0,2,2,6,6,3,3,3,6,6,0,1,0,1,0,1,2,1,0,2,2,1,2,0,2,2,2,0,1,2,2,2,0,1,0,2,2,2,0,2,1,1,0,0,0,2,0,2,0,0,2,1,0,0,0,2,1,0,1,0,2,1,2,1,2,3,3,3,0,1,0,0,0,2,2,1,2,2,1,1,0,1,0,1,2,2,0,2,1,1,2,7,7,7,7
7,7,7,0,1,0,1,0,2,2,0,0,1,1,0,1,0,0,6,6,3,3,3,6,6,0,2,0,0,1,2,2,0,0,2,0,2,2,1,1,2,0,2,0,2,1,0,2,1,2,1,0,0,1,1,0,1,1,0,2,0,2,0,1,0,2,0,0,1,2,0,0,2,0,2,2,0,1,2,2,3,3,3,0,2,0,2,2,0,2,1,0,0,1,1,1,2,2,1,1,2,1,2,0,1,0,1,7,7,7
7,7,7,0,1,2,1,2,2,1,0,0,0,2,1,0,0,0,6,6,3,3,3,6,6,6,6,6,6,6,6,6,6,6,2,0,0,2,2,2,0,0,0,1,1,2,0,0,1,6,6,6,6,6,6,6,6,6,6,6,0,0,1,2,2,2,1,1,1,2,0,2,0,2,1,0,2,0,0,0,3,3,3,0,0,1,1,1,0,1,1,2,0,1,0,1,1,0,2,1,1,2,2,0,1,0,7,7,7,7
7,7,7,2,1,2,1,0,1,0,1,0,0,0,0,2,0,2,6,6,3,3,3,6,6,6,6,6,6,6,6,6,6,6,1,0,2,2,2,0,1,2,0,1,2,1,0,2,2,6,6,6,6,6,6,6,6,6,6,6,1,0,1,2,1,0,1,1,1,1,2,1,1,1,1,0,1,2,0,2,3,3,3,0,2,2,1,1,1,1,1,1,1,1,0,2,0,0,0,1,0,1,1,1,0,0,7,7,7,7
7,7,7,2,0,1,2,2,0,0,2,0,0,0,1,2,1,2,6,6,3,3,3,3,3,3,3,3,3,3,3,3,3,3,3,3,3,3,3,3,3,3,3,3,3,3,3,3,3,3,3,3,3,3,3,3,3,3,3,3,3,3,3,3,3,3,3,3,3,3,3,3,3,3,3,3,3,3,3,3,3,3,3,1,2,1,1,2,2,1,0,2,2,0,0,2,0,0,2,1,0,2,0,1,0,2,7,7,7,7
7,7,7,7,0,2,2,0,0,0,1,2,1,1,0,0,2,1,6,6,3,3,3,3,3,3,3,3,3,3,3,3,3,3,3,3,3,3,3,3,3,3,3,3,3,3,3,3,3,3,3,3,3,3,3,3,3,3,3,3,3,3,3,3,3,3,3,3,3,3,3,3,3,3,3,3,3,3,3,3,3,3,3,0,2,2,0,2,2,1,1,2,0,0,1,2,1,1,2,0,1,0,1,0,1,2,7,7,7,7
7,7,7,7,1,2,1,2,2,1,1,1,0,1,2,1,2,1,6,6,3,3,3,3,3,3,3,3,3,3,3,3,3,3,3,3,3,3,3,3,3,3,3,3,3,3,3,3,3,3,3,3,3,3,3,3,3,3,3,3,3,3,3,3,3,3,3,3,3,3,3,3,3,3,3,3,3,3,3,3,3,3,3,0,2,2,2,2,0,2,0,2,1,0,2,1,1,0,1,1,2,0,0,1,1,1,0,7,7,7
7,7,7,7,2,0,1,0,1,1,2,1,2,0,2,0,2,0,6,6,3,3,3,6,6,6,6,6,6,6,6,6,6,6,2,2,2,1,0,3,3,3,3,1,1,2,1,1,2,6,6,6,6,3,3,3,6,6,6,6,1,1,0,2,0,1,2,0,2,1,0,0,1,0,2,2,1,2,1,2,3,3,3,1,0,0,1,1,1,2,0,0,0,1,1,0,2,1,2,0,0,0,0,0,2,2,0,7,7,7
7,7,7,7,1,0,0,2,2,2,0,1,0,2,2,0,2,0,6,6,3,3,3,6,6,6,6,6,6,6,6,6,6,6,1,0,0,1,2,3,3,3,3,2,0,1,0,0,1,6,6,6,6,3,3,3,6,6,6,6,0,1,2,1,2,0,2,0,2,2,0,2,1,1,0,1,2,1,1,1,3,3,3,0,0,1,1,2,1,2,2,2,2,1,1,2,1,0,2,2,1,2,0,0,2,1,7,7,7,7
7,7,7,7,3,3,3,3,3,3,3,3,3,3,3,3,3,3,3,3,3,3,3,6,6,2,2,1,1,2,0,1,1,1,2,1,2,1,2,3,3,3,3,0,0,0,2,2,0,2,1,6,6,3,3,3,6,6,1,1,2,0,2,0,0,2,1,0,1,0,0,2,1,1,2,0,1,2,2,2,3,3,3,1,1,0,0,0,0,1,0,0,1,0,2,1,1,2,2,2,1,0,1,0,1,1,7,7,7,7
7,7,7,3,3,3,3,3,3,3,3,3,3,3,3,3,3,3,3,3,3,3,3,6,6,1,0,2,0,0,0,1,0,2,1,2,2,1,2,3,3,3,3,0,0,1,0,0,1,2,0,6,6,3,3,3,6,6,0,1,2,2,0,0,1,2,1,1,1,2,2,2,2,0,0,2,2,1,0,2,3,3,3,0,0,0,1,0,1,1,1,2,2,1,2,0,0,2,0,1,0,0,2,0,2,2,1,7,7,7
7,7,7,3,3,3,3,3,3,3,3,3,3,3,3,3,3,3,3,3,3,3,3,6,6,1,2,0,2,2,1,2,1,0,0,0,2,2,1,3,3,3,3,0,0,0,1,1,1,1,0,2,2,3,3,3,1,1,2,1,1,0,0,0,0,2,2,1,2,2,0,0,0,0,2,1,1,0,1,0,3,3,3,0,1,0,0,1,1,2,1,0,1,1,1,0,0,2,2,1,0,1,0,0,0,0,1,7,7,7
7,7,7,1,1,0,2,0,1,1,0,0,0,1,1,0,1,0,6,6,3,3,3,6,6,2,1,0,2,0,0,2,1,2,0,2,0,2,0,3,3,3,3,0,2,1,2,2,2,1,1,2,0,3,3,3,2,0,2,0,0,0,1,1,1,2,2,0,1,1,0,0,0,0,1,1,2,2,0,0,3,3,3,2,2,0,1,1,0,0,1,2,1,1,0,2,2,1,2,0,1,2,2,1,0,1,7,7,7,7
7,7,7,2,2,1,2,2,2,1,1,1,1,0,1,1,1,2,6,6,3,3,3,6,6,1,0,1,2,0,2,1,1,1,1,1,2,2,2,3,3,3,3,2,2,2,1,2,2,2,0,2,2,3,3,3,2,1,1,0,1,0,0,1,1,2,0,1,1,1,1,2,1,0,0,2,0,2,1,2,3,3,3,2,0,0,2,1,1,1,2,1,1,2,2,1,0,2,2,0,0,0,1,1,2,2,7,7,7,7
7,7,7,7,2,1,1,2,0,2,2,2,2,0,2,1,2,2,6,6,3,3,3,6,6,0,2,2,0,0,0,0,0,2,6,6,6,6,6,3,3,3,3,6,6,6,6,6,2,2,1,0,2,3,3,3,0,2,2,0,0,0,2,1,0,1,2,2,1,2,2,2,2,0,0,2,1,1,2,2,3,3,3,2,0,1,1,2,1,2,0,1,2,2,1,1,2,0,0,1,1,0,2,1,1,0,7,7,7,7
7,7,7,7,0,1,0,2,0,1,1,1,0,1,2,1,0,1,6,6,3,3,3,6,6,2,2,2,0,0,2,0,1,1,6,6,6,6,6,3,3,3,3,6,6,6,6,6,2,1,1,0,2,3,3,3,0,0,1,2,0,0,1,2,1,2,0,2,1,2,0,2,0,2,0,2,0,0,1,1,3,3,3,0,0,2,2,0,0,1,2,1,1,2,1,0,2,2,2,0,1,2,2,1,1,2,7,7,7,7
7,7,7,7,1,1,1,2,0,0,2,0,2,1,1,2,1,1,6,6,3,3,3,6,6,1,2,1,0,1,1,2,2,2,6,6,3,3,3,3,3,3,3,3,3,3,6,6,2,1,2,0,1,3,3,3,1,1,2,2,2,2,1,2,0,0,0,1,1,0,2,2,0,1,1,0,1,2,2,2,3,3,3,2,1,2,1,0,0,1,1,0,2,1,2,0,2,2,0,0,0,2,2,1,1,1,1,7,7,7
7,7,7,7,0,2,0,1,1,0,1,2,1,2,1,2,0,0,6,6,3,3,3,6,6,2,0,1,0,1,2,1,1,1,6,6,3,3,3,3,3,3,3,3,3,3,6,6,2,1,2,0,2,3,3,3,1,1,0,2,2,1,0,2,1,1,1,0,2,1,0,1,0,1,1,0,0,0,2,1,3,3,3,1,2,0,0,1,0,0,1,0,0,2,1,1,2,2,0,1,2,2,2,0,1,2,2,7,7,7
7,7,7,1,2,2,2,0,0,1,0,1,0,2,2,0,1,0,6,6,3,3,3,6,6,2,1,1,2,0,0,2,0,2,6,6,3,3,3,3,3,3,3,3,3,3,6,6,1,1,1,0,2,3,3,3,0,2,0,0,0,2,0,2,1,0,2,0,2,0,1,0,1,0,2,2,0,2,0,1,3,3,3,2,2,2,2,0,2,0,2,0,2,1,1,0,1,0,1,1,0,1,2,2,1,1,0,7,7,7
7,7,7,2,0,0,0,2,0,1,2,1,0,2,0,2,2,1,6,6,3,3,3,3,3,3,3,3,3,3,3,3,3,3,3,3,3,3,3,3,6,6,3,3,3,3,3,3,3,3,3,3,3,3,3,3,0,1,2,1,0,1,2,2,0,1,1,2,0,2,2,0,0,1,2,2,0,1,1,1,3,3,3,2,0,2,0,0,2,0,1,0,2,2,1,1,0,1,2,0,0,1,0,1,0,0,0,7,7,7
7,7,7,1,1,1,1,0,2,2,2,1,1,1,0,2,2,1,6,6,3,3,3,3,3,3,3,3,3,3,3,3,3,3,3,3,3,3,3,6,6,6,6,3,3,3,3,3,3,3,3,3,3,3,3,3,2,0,1,2,1,1,1,0,2,0,0,2,1,0,2,0,1,0,2,1,2,0,1,2,3,3,3,0,1,0,0,0,2,0,0,1,2,0,1,2,1,2,2,0,2,2,2,1,0,1,2,7,7,7
7,7,7,1,1,0,0,2,1,2,0,2,0,1,0,0,1,0,6,6,3,3,3,3,3,3,3,3,3,3,3,3,3,3,3,3,3,3,3,6,6,6,6,3,3,3,3,3,3,3,3,3,3,3,3,3,2,2,0,0,1,0,2,2,1,0,0,2,1,0,0,0,1,1,2,0,0,2,2,1,3,3,3,0,2,0,0,2,0,0,2,1,2,1,0,2,1,2,2,0,1,1,0,2,0,0,2,7,7,7
7,7,7,0,2,0,2,1,2,2,0,2,0,1,0,2,2,1,2,0,0,0,2,1,1,1,1,2,3,3,3,3,3,3,3,3,3,3,3,3,6,6,3,3,3,3,3,3,3,3,3,3,3,3,3,3,2,0,2,0,0,2,1,0,0,1,0,0,1,0,1,1,1,0,2,1,2,0,0,0,3,3,3,0,2,2,2,0,2,1,0,2,2,2,0,0,0,1,2,0,1,1,0,1,1,2,0,7,7,7
7,7,7,7,2,1,0,1,1,0,0,0,0,0,0,0,0,1,2,1,2,2,1,1,0,0,0,2,3,3,3,1,1,1,6,6,3,3,3,3,3,3,3,3,3,3,6,6,2,0,2,1,1,3,3,3,1,1,0,1,2,1,0,2,2,2,2,1,2,1,2,0,1,1,2,0,1,0,0,2,3,3,3,1,2,1,0,0,1,1,0,2,0,0,1,2,0,2,0,1,1,2,2,0,2,2,1,7,7,7
7,7,7,7,1,2,0,2,1,2,0,2,0,0,0,0,0,1,2,0,2,1,1,1,1,2,0,0,3,3,3,0,0,2,6,6,3,3,3,3,3,3,3,3,3,3,6,6,0,1,1,1,2,3,3,3,1,2,0,0,1,0,2,2,0,1,1,1,2,0,1,2,0,2,0,2,1,0,2,1,3,3,3,1,0,0,1,1,1,2,0,0,1,2,1,2,1,1,1,0,2,0,0,1,2,2,1,7,7,7
7,7,7,7,0,2,1,1,1,0,1,0,2,2,0,1,2,2,1,1,1,1,2,2,1,2,2,2,3,3,3,0,2,0,6,6,3,3,3,3,3,3,3,3,3,3,6,6,2,0,2,1,2,3,3,3,2,2,1,2,1,0,0,2,1,0,0,1,0,2,1,1,2,1,0,2,1,2,1,2,3,3,3,3,3,3,3,3,3,3,3,3,3,3,3,3,3,3,3,3,3,3,3,3,3,3,3,7,7,7
7,7,7,0,1,2,0,0,1,0,1,0,2,0,0,0,2,1,0,2,1,1,2,0,1,0,1,0,3,3,3,1,0,2,6,6,6,6,6,3,3,3,3,6,6,6,6,6,2,2,2,2,0,3,3,3,2,0,2,2,1,2,0,0,1,1,0,2,2,1,1,0,2,0,0,1,1,2,1,0,3,3,3,3,3,3,3,3,3,3,3,3,3,3,3,3,3,3,3,3,3,3,3,3,3,3,3,7,7,7
7,7,7,0,1,0,2,1,0,0,1,2,2,0,1,0,2,1,1,2,1,0,0,0,0,2,2,2,3,3,3,0,2,1,6,6,6,6,6,3,3,3,3,6,6,6,6,6,1,0,2,0,0,3,3,3,1,0,2,1,0,0,0,2,0,0,0,0,1,0,2,2,2,2,0,0,1,2,2,1,3,3,3,3,3,3,3,3,3,3,3,3,3,3,3,3,3,3,3,3,3,3,3,3,3,3,7,7,7,7
7,7,7,0,2,2,2,0,0,2,0,2,2,0,0,2,2,0,2,0,0,1,0,1,0,1,2,0,3,3,3,0,2,1,0,1,1,1,0,3,3,3,3,2,2,1,0,1,1,2,2,1,0,3,3,3,0,1,0,1,1,0,2,0,1,1,0,2,2,0,0,2,1,0,0,1,2,1,0,2,0,0,1,1,1,2,0,2,2,2,0,2,3,3,3,2,2,1,0,0,1,1,0,1,1,2,7,7,7,7
7,7,7,1,1,2,0,2,2,1,1,0,1,1,2,2,1,2,1,2,0,0,2,2,0,0,1,1,3,3,3,0,2,1,1,2,1,2,1,3,3,3,3,1,2,2,1,2,0,2,1,2,2,3,3,3,2,0,2,2,0,1,1,2,1,0,0,2,2,2,2,2,0,2,2,2,0,2,0,1,0,1,1,1,1,2,0,0,1,1,0,1,3,3,3,1,1,0,0,2,1,0,1,0,1,2,7,7,7,7
7,7,7,2,2,0,1,2,0,1,1,1,2,1,0,0,0,1,0,1,1,2,0,2,0,1,6,6,3,3,3,6,6,1,1,0,1,1,0,3,3,3,3,1,0,1,1,1,0,1,2,0,2,3,3,3,1,1,0,1,1,2,2,0,1,2,1,1,2,2,1,2,1,1,1,2,1,1,2,2,2,2,0,1,0,1,2,1,2,0,2,0,3,3,3,2,0,1,2,1,1,2,1,2,1,1,7,7,7,7
7,7,7,7,1,1,1,0,0,1,1,1,0,1,0,2,0,2,2,2,2,2,0,1,1,0,6,6,3,3,3,6,6,1,1,0,0,2,1,3,3,3,3,1,0,1,1,0,1,1,0,0,2,3,3,3,1,0,0,0,0,1,0,0,1,0,1,2,0,2,2,2,2,1,1,1,1,2,2,1,2,2,1,0,2,0,0,1,0,2,2,1,3,3,3,0,0,0,2,2,1,1,0,0,1,0,7,7,7,7
7,7,7,7,2,1,2,0,1,2,2,2,0,1,1,0,2,2,2,0,0,0,0,1,1,2,6,6,3,3,3,6,6,6,6,0,1,0,2,3,3,3,3,1,1,0,2,2,1,0,1,2,2,3,3,3,6,6,6,6,6,6,6,6,6,6,2,1,1,1,0,2,1,2,0,0,2,1,2,1,0,0,0,2,2,0,2,1,2,0,1,2,3,3,3,0,2,2,1,2,2,2,1,0,2,0,7,7,7,7
7,7,7,7,1,0,2,2,0,2,2,1,0,0,1,2,2,2,2,1,2,0,2,2,1,0,6,6,3,3,3,6,6,6,6,1,0,2,1,3,3,3,3,1,2,1,0,2,0,2,0,2,0,3,3,3,6,6,6,6,6,6,6,6,6,6,0,1,1,0,2,2,0,0,1,0,0,1,0,0,2,2,2,0,2,2,0,2,0,1,1,0,3,3,3,1,2,1,0,2,0,2,1,1,2,0,0,7,7,7
7,7,7,7,1,0,0,0,1,2,0,0,0,0,0,2,2,2,1,0,0,2,6,6,6,6,6,6,3,3,3,3,3,3,3,3,3,3,3,3,3,3,3,3,3,3,3,3,3,3,3,3,3,3,3,3,3,3,3,3,3,3,3,3,6,6,2,0,2,1,0,2,2,0,2,0,2,2,2,0,0,2,2,2,0,2,1,2,1,0,0,2,3,3,3,1,2,0,0,0,1,2,1,0,0,0,1,7,7,7
7,7,7,7,0,0,0,2,1,1,1,2,0,0,2,0,2,2,1,1,0,1,6,6,6,6,6,6,3,3,3,3,3,3,3,3,3,3,3,3,3,3,3,3,3,3,3,3,3,3,3,3,3,3,3,3,3,3,3,3,3,3,3,3,6,6,0,2,0,0,2,0,0,2,0,0,2,2,1,1,1,0,1,0,0,1,0,0,1,0,1,0,3,3,3,2,0,1,2,0,0,1,1,1,0,1,1,7,7,7
7,7,7,7,3,3,3,3,3,3,3,3,3,3,3,3,3,3,3,3,3,3,3,3,3,3,3,3,3,3,3,3,3,3,3,3,3,3,3,3,3,3,3,3,3,3,3,3,3,3,3,3,3,3,3,3,3,3,3,3,3,3,3,3,6,6,2,0,0,1,0,1,1,2,1,1,1,0,2,1,0,0,1,2,0,0,1,1,0,1,2,0,3,3,3,2,0,1,0,2,2,2,1,2,0,1,2,7,7,7
7,7,7,3,3,3,3,3,3,3,3,3,3,3,3,3,3,3,3,3,3,3,3,3,3,3,3,3,3,3,3,6,6,6,6,0,0,1,2,2,1,0,2,1,2,0,2,2,1,1,0,2,0,1,2,2,6,6,6,6,6,3,3,3,6,6,2,0,2,1,2,2,0,0,2,1,2,1,1,1,1,1,1,0,0,2,0,0,1,0,0,0,3,3,3,2,1,2,0,0,1,2,0,2,1,0,7,7,7,7
7,7,7,3,3,3,3,3,3,3,3,3,3,3,3,3,3,3,3,3,3,3,3,3,3,3,3,3,3,3,3,6,6,6,6,2,0,2,2,2,1,1,1,1,2,0,0,2,2,0,0,0,2,1,1,0,6,6,6,6,6,3,3,3,6,6,2,0,2,1,2,2,0,2,1,2,2,0,1,2,2,0,1,2,2,2,2,0,0,0,1,1,3,3,3,1,0,2,0,0,0,2,0,0,2,2,7,7,7,7
7,7,7,7,0,0,0,2,0,2,1,1,1,2,2,2,0,2,1,1,2,1,6,6,6,6,6,6,3,3,3,6,6,2,1,2,0,1,0,0,2,2,1,1,2,1,0,1,0,2,2,0,2,1,0,0,0,2,1,6,6,3,3,3,6,6,2,0,2,1,1,0,2,1,0,0,2,2,2,0,0,0,2,1,0,2,1,0,1,2,2,2,3,3,3,1,0,2,0,1,2,1,2,2,0,1,7,7,7,7
7,7,7,7,0,2,2,0,2,0,2,0,0,0,2,0,0,1,0,1,0,1,6,6,6,6,6,6,3,3,3,6,6,0,2,0,2,0,1,0,0,0,0,1,0,1,1,0,0,2,0,2,2,1,0,1,2,1,2,6,6,3,3,3,6,6,1,0,2,2,1,1,1,1,0,0,1,1,1,1,2,1,2,0,1,2,1,0,1,2,0,0,3,3,3,2,1,2,2,1,2,1,1,1,0,1,0,7,7,7
7,7,7,7,1,1,0,0,1,2,1,0,2,1,0,2,2,0,0,0,2,2,1,1,1,0,6,6,3,3,3,6,6,0,2,0,0,0,0,1,2,1,2,0,0,0,0,1,2,2,2,0,1,2,0,1,0,1,0,6,6,3,3,3,6,6,1,1,2,2,2,0,1,0,1,2,1,2,2,1,0,2,1,1,1,0,1,2,0,0,2,2,3,3,3,2,1,1,0,0,0,1,2,2,0,1,2,7,7,7
7,7,7,0,2,2,1,0,2,2,0,2,2,2,0,2,0,2,2,2,2,0,2,1,2,0,6,6,3,3,3,6,6,1,2,2,0,1,2,0,0,0,0,2,2,0,0,2,0,1,0,0,2,0,2,0,1,2,0,1,0,3,3,3,0,2,2,0,2,2,1,2,1,2,0,1,1,2,1,1,1,0,0,1,1,0,2,1,0,2,0,1,3,3,3,2,2,0,0,1,2,1,1,0,1,2,2,7,7,7
7,7,7,7,0,1,0,0,0,0,0,1,2,0,0,1,2,1,1,2,2,2,0,2,0,2,0,0,3,3,3,2,2,2,2,1,1,2,0,1,1,2,2,0,0,2,2,0,0,2,2,2,0,0,2,0,2,0,1,0,2,3,3,3,0,2,0,0,0,1,1,2,2,2,2,1,1,0,2,2,1,0,0,1,0,1,1,2,1,1,1,0,3,3,3,0,1,2,2,2,2,0,1,0,2,1,1,7,7,7
7,7,7,7,1,1,1,0,0,2,2,1,2,2,0,2,2,0,1,1,2,2,0,1,1,1,0,0,3,3,3,2,2,1,2,0,1,1,2,2,1,2,0,1,0,1,0,1,2,2,2,0,2,2,1,1,1,2,2,1,0,3,3,3,2,0,2,2,1,2,0,0,0,2,2,0,0,0,0,0,0,1,0,1,0,2,1,1,0,1,2,2,3,3,3,0,2,0,2,0,1,1,0,1,1,0,2,7,7,7
7,7,7,7,1,0,2,0,1,2,1,0,2,1,0,0,0,0,2,2,2,2,1,2,1,0,1,0,3,3,3,2,1,2,2,2,1,0,2,0,1,0,0,1,1,1,2,2,2,2,2,0,2,2,0,2,2,2,2,1,0,3,3,3,0,1,1,2,2,1,2,2,2,2,2,2,2,1,1,1,1,0,1,2,2,0,1,2,1,2,0,0,3,3,3,2,1,0,1,0,1,2,0,1,2,0,2,7,7,7
7,7,7,7,1,1,0,1,1,1,2,0,1,1,2,2,2,2,1,0,2,2,1,1,1,1,1,1,3,3,3,2,0,2,0,2,0,0,0,2,2,0,0,0,0,0,1,1,0,1,2,2,1,2,1,2,0,2,0,2,2,3,3,3,0,2,1,1,2,0,2,0,2,2,2,0,2,0,0,0,2,1,0,0,1,0,0,1,1,1,0,2,3,3,3,0,2,0,0,2,2,1,0,1,1,1,2,7,7,7
7,7,7,2,1,2,2,2,0,2,0,2,1,1,2,1,0,1,0,2,0,2,1,0,1,1,1,2,3,3,3,2,0,2,0,2,0,2,0,0,0,0,0,2,1,1,1,0,2,0,1,0,2,1,2,2,0,0,2,1,1,3,3,3,2,1,2,1,2,0,2,0,0,1,2,0,0,1,0,1,1,0,1,2,0,1,1,2,0,0,1,0,3,3,3,2,1,0,0,0,1,0,1,1,2,1,7,7,7,7
7,7,7,7,0,0,0,0,2,1,1,1,2,2,1,1,2,2,0,0,0,2,2,2,1,0,2,1,3,3,3,1,1,2,0,1,1,2,0,0,2,0,2,0,0,1,1,1,1,2,1,1,1,1,0,2,2,2,0,2,2,3,3,3,0,2,2,2,2,1,0,0,1,0,1,1,1,0,0,0,0,1,2,2,2,0,1,2,0,0,2,0,3,3,3,2,2,2,2,1,2,0,1,1,2,2,7,7,7,7
7,7,7,7,0,2,0,0,0,0,2,2,1,2,2,1,2,2,1,1,2,1,0,1,2,1,1,1,3,3,3,0,2,0,0,0,1,0,1,1,2,0,0,1,2,2,2,2,1,0,1,2,1,1,0,1,2,1,1,2,2,3,3,3,0,2,2,2,0,1,1,0,1,2,1,0,1,0,2,0,2,1,1,0,0,1,2,0,0,2,0,2,3,3,3,0,0,1,0,1,2,0,1,1,0,2,2,7,7,7
7,7,7,7,1,2,2,1,0,2,2,0,0,1,2,8,0,9,0,1,1,1,2,0,2,0,2,1,3,3,3,1,2,1,1,0,1,1,0,0,0,1,2,1,0,1,0,1,0,1,0,2,2,2,1,2,1,0,1,0,1,3,3,3,2,2,2,1,1,0,1,1,0,1,2,1,2,2,0,0,0,1,2,0,1,0,1,2,1,0,1,0,3,3,3,0,0,1,2,2,0,0,0,0,1,0,2,7,7,7
7,7,7,2,2,2,2,0,0,0,1,2,2,1,9,0,8,1,0,0,0,2,0,2,0,1,6,6,3,3,3,6,6,2,0,2,0,1,0,0,2,1,2,2,1,1,1,2,2,2,1,1,1,2,1,2,1,0,2,2,0,3,3,3,2,1,0,2,2,0,1,2,0,2,0,1,1,2,1,2,1,2,2,2,1,2,1,0,2,2,2,2,3,3,3,1,2,0,1,2,2,2,2,1,1,2,7,7,7,7
7,7,7,0,0,2,2,0,0,0,0,2,1,1,1,0,9,8,0,1,1,2,0,1,0,2,6,6,3,3,3,6,6,2,1,0,2,0,2,2,0,1,1,2,2,0,1,0,1,1,1,1,1,0,2,0,0,2,1,1,0,3,3,3,2,2,2,0,1,1,2,1,2,1,1,1,0,0,2,0,1,1,2,0,2,2,1,2,2,2,0,1,3,3,3,2,1,1,0,2,0,2,0,2,0,1,7,7,7,7
7,7,7,0,1,0,2,0,2,2,2,1,7,2,2,9,2,0,7,7,1,2,0,1,6,6,6,6,3,3,3,6,6,0,1,1,2,1,1,0,0,0,2,1,2,0,1,0,0,2,2,0,2,1,0,0,0,0,2,1,1,3,3,3,2,2,2,0,1,2,0,1,2,1,2,0,0,1,2,2,2,0,1,1,0,2,1,0,0,1,1,2,3,3,3,2,1,0,1,0,2,2,2,2,1,1,0,7,7,7
7,7,7,0,0,7,7,7,7,7,7,7,7,7,9,8,9,8,7,7,7,2,2,2,6,6,6,6,3,3,3,6,6,2,2,0,0,2,0,0,1,1,0,0,2,2,1,0,0,2,1,0,2,1,1,0,0,1,1,1,2,3,3,3,2,0,2,0,1,1,0,2,1,0,2,0,2,0,1,2,0,1,1,1,1,2,1,0,2,2,1,0,3,3,3,2,1,1,0,2,0,1,2,0,1,2,2,7,7,7
7,7,7,7,7,7,7,7,7,7,7,7,7,7,9,9,9,7,7,7,7,3,3,3,3,3,3,3,3,3,3,6,6,2,1,2,0,0,2,2,2,2,1,0,2,2,2,1,0,0,1,0,1,1,1,1,1,0,1,0,2,3,3,3,1,0,2,2,1,1,2,2,1,0,1,0,1,1,2,0,2,2,0,1,0,0,2,0,1,1,1,1,3,3,3,0,0,0,2,0,2,0,1,1,0,2,0,7,7,7
7,7,7,7,7,7,7,7,7,7,7,7,7,7,8,8,8,7,7,7,7,3,3,3,3,3,3,3,3,3,3,6,6,6,6,1,0,0,1,1,1,1,2,1,1,2,2,0,1,1,1,0,0,2,0,2,1,0,1,2,2,3,3,3,0,1,0,0,0,1,0,1,2,1,1,2,2,2,1,0,0,1,1,0,1,2,2,1,1,0,1,0,3,3,3,0,0,2,2,2,0,2,1,2,0,1,2,7,7,7
7,7,7,7,7,7,7,9,8,9,8,8,9,9,8,9,9,8,7,7,7,7,3,3,3,3,3,3,3,3,3,6,6,6,6,2,0,2,0,2,1,0,0,0,1,1,2,0,0,1,1,2,1,2,1,0,0,1,1,1,2,3,3,3,1,2,0,1,0,1,0,2,1,2,2,0,2,2,2,1,0,0,2,0,0,0,1,0,2,2,2,1,3,3,3,0,1,1,1,1,0,0,1,0,2,0,1,7,7,7
7,7,7,7,9,8,8,8,9,9,9,8,9,9,8,9,8,9,7,7,7,7,7,0,6,6,6,6,3,3,3,3,3,3,3,3,3,3,3,3,3,3,3,3,3,3,3,3,3,3,3,3,3,3,3,3,3,3,3,3,3,3,3,3,3,3,3,3,3,3,3,3,3,3,3,3,3,3,3,3,3,3,3,3,3,3,3,3,3,3,3,3,3,3,3,3,3,3,3,3,3,3,3,3,3,3,3,7,7,7
7,7,7,8,9,9,8,9,8,8,8,8,8,8,9,8,9,9,9,9,7,7,7,7,6,6,6,6,3,3,3,3,3,3,3,3,3,3,3,3,3,3,3,3,3,3,3,3,3,3,3,3,3,3,3,3,3,3,3,3,3,3,3,3,3,3,3,3,3,3,3,3,3,3,3,3,3,3,3,3,3,3,3,3,3,3,3,3,3,3,3,3,3,3,3,3,3,3,3,3,3,3,3,3,3,3,3,7,7,7
7,7,7,9,9,8,9,8,8,9,8,9,8,8,9,8,9,9,9,8,7,7,7,7,7,7,6,6,3,3,3,3,3,3,3,3,3,3,3,3,3,3,3,3,3,3,3,3,3,3,3,3,3,3,3,3,3,3,3,3,3,3,3,3,3,3,3,3,3,3,3,3,3,3,3,3,3,3,3,3,3,3,3,3,3,3,3,3,3,3,3,3,3,3,3,3,3,3,3,3,3,3,3,3,3,3,7,7,7,7
7,7,7,9,9,8,9,9,9,8,9,9,8,8,8,8,8,9,8,9,8,7,7,7,7,7,6,6,3,3,3,6,6,6,6,0,0,1,1,1,0,1,2,0,1,1,1,0,0,2,0,2,1,0,2,1,1,1,1,1,2,0,1,1,0,1,2,0,1,0,1,1,2,2,2,0,1,0,2,2,1,3,3,3,1,1,2,1,2,1,2,1,1,2,0,1,2,1,1,0,0,2,0,0,0,1,7,7,7,7
7,7,7,9,8,9,8,9,8,8,8,9,9,8,8,9,9,9,8,9,9,9,7,7,7,7,6,6,3,3,3,6,6,6,6,0,1,0,1,2,1,2,2,0,2,0,1,2,1,0,1,2,2,0,0,0,2,1,1,2,2,1,0,2,1,2,2,0,0,0,2,2,0,2,1,0,1,2,2,1,0,3,3,3,1,1,2,1,0,0,1,0,1,2,0,0,2,2,2,1,0,1,0,1,0,2,7,7,7,7
7,7,7,8,8,9,9,8,8,8,8,8,9,9,8,9,8,9,8,9,8,8,8,7,7,7,6,6,3,3,3,6,6,2,2,0,2,0,0,2,2,0,1,2,2,0,1,0,1,0,0,1,0,2,2,2,2,1,1,2,0,1,2,2,2,1,2,1,0,2,1,2,1,1,2,1,2,2,0,1,0,3,3,3,1,0,2,0,2,0,0,0,0,1,2,2,2,0,0,2,1,0,0,0,0,2,7,7,7,7
7,7,7,8,8,9,8,8,9,8,8,8,8,8,9,9,9,8,9,8,8,9,8,7,7,7,6,6,3,3,3,6,6,2,1,2,2,0,2,0,0,1,2,2,1,1,0,2,2,2,1,0,2,2,0,1,2,2,2,0,1,1,0,1,2,0,0,0,0,2,2,0,0,2,2,2,0,2,0,0,1,3,3,3,1,2,2,2,1,1,1,0,1,1,1,0,1,2,0,2,1,1,0,0,2,0,7,7,7,7
7,7,7,7,8,9,8,8,9,9,9,9,8,8,8,8,9,9,9,8,9,9,9,8,7,7,7,1,3,3,3,0,2,0,2,2,0,0,2,0,1,0,1,0,1,2,2,1,1,1,1,0,1,2,0,1,2,1,2,1,1,2,0,1,0,0,2,0,0,2,2,2,0,1,0,2,2,0,0,1,2,3,3,3,0,1,0,2,2,0,2,0,2,2,2,1,1,2,0,2,0,0,2,0,0,0,0,7,7,7
7,7,7,7,9,8,9,8,9,9,8,9,9,9,8,9,8,8,9,9,9,8,9,9,7,7,7,7,3,3,3,2,0,1,0,2,2,2,1,0,0,1,0,0,1,1,1,0,0,1,0,1,2,1,2,1,2,0,2,2,0,1,2,1,1,2,1,2,0,2,2,2,0,2,2,0,1,1,2,2,2,3,3,3,2,1,0,1,2,0,0,0,2,0,2,0,0,0,1,2,0,1,0,0,2,2,2,7,7,7
7,7,7,7,9,9,8,9,9,8,9,8,8,9,9,8,8,9,8,8,9,8,8,8,7,7,7,7,3,3,3,0,0,1,2,0,1,0,0,0,1,0,2,1,2,2,2,1,2,0,1,2,2,0,2,2,1,2,1,1,2,2,0,1,2,1,2,2,2,0,2,2,0,1,1,1,0,1,0,0,0,3,3,3,0,0,1,2,2,2,2,2,2,0,2,2,0,2,1,0,2,1,0,0,0,0,2,7,7,7
7,7,7,9,8,9,8,9,8,8,9,9,9,9,8,8,8,8,9,9,8,9,8,8,7,7,7,1,3,3,3,0,1,0,0,1,2,0,1,0,2,1,0,1,1,2,1,2,2,0,1,1,2,2,1,1,1,2,0,2,2,0,0,2,0,2,1,0,2,1,1,2,1,1,2,0,2,1,0,1,2,3,3,3,1,2,0,0,0,1,2,2,0,2,0,0,1,1,2,0,0,1,0,0,0,2,2,7,7,7
7,7,7,8,9,8,8,9,9,9,9,8,8,9,8,8,9,8,8,8,9,8,8,8,7,7,7,2,3,3,3,0,0,0,2,2,0,0,1,2,2,2,1,1,2,2,1,1,0,1,1,1,1,0,1,0,0,0,2,1,2,1,0,1,0,0,0,2,1,0,1,2,1,2,1,1,1,0,1,2,2,3,3,3,2,1,0,1,0,1,0,0,2,1,0,0,2,2,1,0,2,2,0,0,2,2,1,7,7,7
7,7,7,7,9,8,8,8,8,8,9,9,8,8,8,9,9,8,9,9,9,8,9,9,7,7,7,2,3,3,3,0,2,2,2,0,0,0,1,0,0,2,0,0,0,2,2,2,2,0,1,2,1,2,2,1,2,0,0,0,1,0,1,1,2,2,1,2,1,2,0,2,2,1,0,0,1,1,1,0,2,3,3,3,2,0,1,0,1,1,1,2,2,0,2,2,0,2,2,1,2,1,0,1,0,2,0,7,7,7
7,7,7,7,8,9,8,9,9,8,8,8,9,9,8,9,8,9,8,8,9,8,8,8,7,7,7,1,3,3,3,1,0,2,1,0,2,1,2,2,1,2,1,2,2,0,2,1,0,1,2,2,0,2,2,1,1,0,0,1,1,1,1,0,2,0,0,0,2,2,1,0,2,2,0,2,2,1,1,0,2,3,3,3,2,0,1,2,1,1,1,0,0,0,2,0,0,0,2,2,1,2,0,0,1,1,7,7,7,7
7,7,7,7,7,7,9,8,9,8,9,9,9,9,9,9,8,9,8,7,7,7,7,7,7,7,7,7,7,7,7,7,7,2,7,7,7,7,7,7,7,7,7,7,7,7,0,0,1,1,1,2,2,2,0,0,1,0,1,2,1,2,2,1,1,1,0,7,7,7,7,2,0,1,2,2,1,0,0,0,2,3,3,3,2,0,0,0,1,2,1,2,0,0,1,2,0,0,0,1,1,0,7,7,7,7,7,7,7,7
7,7,7,7,7,7,7,7,7,7,7,7,7,7,7,7,7,7,7,7,7,7,7,7,7,7,7,7,7,7,7,7,7,7,7,7,7,7,7,7,7,7,7,7,7,7,7,7,7,7,7,7,7,7,7,7,7,7,7,7,7,7,7,7,7,7,7,7,7,7,7,7,7,7,7,7,7,7,7,7,7,7,7,7,7,7,7,7,7,7,7,7,7,7,7,7,7,7,7,7,7,7,7,7,7,7,7,7,7,7
7,7,7,7,7,7,7,7,7,7,7,7,7,7,7,7,7,7,7,7,7,7,7,7,7,7,7,7,7,7,7,7,7,7,7,7,7,7,7,7,7,7,7,7,7,7,7,7,7,7,7,7,7,7,7,7,7,7,7,7,7,7,7,7,7,7,7,7,7,7,7,7,7,7,7,7,7,7,7,7,7,7,7,7,7,7,7,7,7,7,7,7,7,7,7,7,7,7,7,7,7,7,7,7,7,7,7,7,7,7
7,7,7,7,7,7,7,7,7,7,7,7,7,7,7,7,7,7,7,7,7,7,7,7,7,7,7,7,7,7,7,7,7,7,7,7,7,7,7,7,7,7,7,7,7,7,7,7,7,7,7,7,7,7,7,7,7,7,7,7,7,7,7,7,7,7,7,7,7,7,7,7,7,7,7,7,7,7,7,7,7,7,7,7,7,7,7,7,7,7,7,7,7,7,7,7,7,7,7,7,7,7,7,7,7,7,7,7,7,7
